111111
1P0001
100C01
1000E1
111111