111111111111111
1P0001C00000001
100C01000010001
100000000C100E1
111111111111111
